%%%%%%%%%%%%%%%%%%%%
%o................o%
%.%%%%.%%%%%%.%%%%.%
%P...%...%%...%....%
%%%%.%.%.%%.%.%.%%%%
%....%...GG...%....%
%%%%.%.%%%%%%.%.%%%%
%....%........%....%
%.%%%%.%%%%%%.%%%%.%
%o................o%
%%%%%%%%%%%%%%%%%%%%
